Team name abbreviations for prediction model. Its important to input the abbreviations exactly how they are shown below.

Atlanta Hawks: ATL
Brooklyn Nets: BKN
Boston Celtics: BOS
Charlotte Hornets: CHA
Chicago Bulls: CHI
Cleveland Cavaliers: CLE
Dallas Mavericks: DAL
Denver Nuggets: DEN
Detroit Pistons: DET
Golden State Warriors: GS
Houston Rockets: HOU
Indiana Pacers: IND
LA Clippers: LAC
Los Angeles Lakers: LAL
Memphis Grizzlies: MEM
Miami Heat: MIA
Milwaukee Bucks: MIL
Minnesota Timberwolves: MIN
New Orleans Pelicans: NO
New York Knicks: NY
Oklahoma City Thunder: OKC
Orlando Magic: ORL
Philadelphia 76ers: PHI
Phoenix Suns: PHO
Portland Trail Blazers: POR
San Antonio Spurs: SA
Sacramento Kings: SAC
Toronto Raptors: TOR
Utah Jazz: UTA
Washington Wizards: WAS